1 13 31
###############################
#p      * *    *   *  * * *   #
#*# #s#* *# #*#*# # # #*#*#*# #
#      * 1***  *      *   * * #
#*#*#*#*#*#*# # #*#*# # # # #*#
#f         x **  *  *         #
#*# #s#*# # # # # #*# #*#*# # #
#   *    1 *  *      *  2 *   #
# #b#*# #*# # # #*#*# # #*# #*#
#*    **  *    f  *    *      #
# #b# # # # # # #*# #*# # # #*#
#      2 f  *   *  *    *     #
###############################