###############################
#p     ** *    * 2 *  * * *   #
# # # #*# # #*#*# # # #*#*#*# #
#   *     ***  *      *   * * #
# # # # # #*# # #*#*# # # # #*#
#f         x **  *  * 1       #
# # # # # # # # # #*# #*# # # #
#   *      *  *      * 2      #
# # # # #*# # # #*#*# # # # # #
#*    **  *       *  1        #
# #b# # # # # # #*# # # # # # #
#      1    *   *  *          #
###############################