1 13 31
###############################
#p      * *    *   *  * * *   #
#*# #s#* *# #*#*# # # #*#*#*# #
#      * 1***  *      *   * * #
#*#*#*#*#*#*# # #*#*# # # # #*#
#f         x **  *  *         #
#*# #s#*# # # # # #*# #*#*# # #
#   *    1 *  *      *    *   #
# #b#*# #*# # # #*#*# # #*# #*#
#*    **  *    f  *    *      #
# #b# # # # # # #*# #*# # # #*#
#      2 f  *   *  *          #
###############################