1 13 31
###############################
#p      * * 3  *   *  * * *   #
#*# #s#* *# #*#*# # # #*#*#*# #
#    1 * #***  *      *   * * #
###b#*#*#*#*# # #*#*# # # # #*#
#f    2    x ** 4* #*         #
### #s#*# # # # # #*# #*#*# # #
#   *      *  *      *    *   #
# #b#*# #*# # # #*#*# # #*# #*#
#*    **  *    f  *    *      #
# #b# # # # # # #*# #*# # # #*#
#        f  *   *  *          #
###############################