1 13 31
###############################
#p     ** *    * 2 *  * * *   #
#*# #s#*#*# #*#*# # # #*#*#*# #
#       1 ***  *      *   * * #
#*#*#*#*#*#*# # #*#*# # # # #*#
#f       1 x **  *  * 1       #
#*# #s#*# # # # # #*# #*#*# # #
#   *      *  *  2   * 2  *   #
# #b#*# #*# # # #*#*# # #*# #*#
#*    **  *    f  *  1 *      #
# #b# # # # # # #*# #*# # # #*#
#      1 f  *   *  *    2     #
###############################